ANA	AA N AH
ANA(2)	AE N AH
BO	B OW
BOOLOOK	B UW L UH K
CAMBA	K AE M B AH
DETA	D AH T AA
EE	IY
FETO	F EH T OW
FUA	F UW AH
FUNI	F Y UW N IY
HEETOO	HH IY T UW
INA	IY N AH
LILO	L IH L OW
MANEK	M AE N AH K
NDANA	N D AE N AH
NEETA	N IY T AH
NGEOO	N JH IY UW
NOOSA	N UW S AH
SAIBOAK	S EY B OW K
SAMBAK	S AE M B AH K
SANDOO	S AE N D UW
SANDU	S AE N D UW
SANGU	S AE N G Y UW
SAREE	S AH R IY IY
TA	T AA
TOOTOO	T UW T UW
